########
#S     #
# ## ###
# #  # #
#   ## #
# # #  #
#     E#
########
